{
  "name": "Town Square",
  "width": 60,
  "height": 30,
  "spawn": {"x": 30, "y": 15},
  "tiles": [
    [1,1,1,1,1,1,1,1,1,1,1,1,1,1,1,1,1,1,1,1,1,1,1,1,1,1,1,1,1,1,1,1,1,1,1,1,1,1,1,1,1,1,1,1,1,1,1,1,1,1,1,1,1,1,1,1,1,1,1,1],
    [1,0,0,3,0,0,0,0,0,0,0,0,0,0,8,8,0,0,3,0,0,0,0,0,0,0,0,0,0,4,0,0,0,0,0,0,0,0,0,0,0,0,3,0,0,3,0,0,0,3,0,0,3,0,0,3,0,0,0,1],
    [1,0,0,0,0,1,1,1,1,1,1,1,0,0,8,0,0,0,0,0,0,0,0,0,0,0,0,0,0,4,0,0,0,0,0,0,0,0,0,0,0,0,0,0,0,0,0,0,3,0,0,0,0,0,3,0,0,0,0,1],
    [1,0,0,0,0,1,6,6,6,6,6,1,0,0,3,0,0,0,0,0,0,0,0,0,0,0,0,0,0,4,0,0,0,0,0,0,0,0,0,0,0,0,0,3,0,0,0,2,2,2,2,2,0,0,0,0,0,0,0,1],
    [1,0,3,0,0,1,6,6,6,6,6,1,0,0,0,0,0,0,0,0,0,1,1,1,1,1,1,0,0,4,0,0,0,0,0,0,0,0,0,3,0,0,0,0,0,0,2,2,2,2,2,2,2,0,0,0,3,0,0,1],
    [1,0,0,0,0,1,6,6,6,6,6,1,0,0,0,0,0,0,0,0,0,1,6,6,6,6,1,0,0,4,0,0,0,0,0,0,0,0,0,0,0,0,0,0,0,2,2,2,2,2,2,2,2,2,0,0,0,0,0,1],
    [1,0,0,0,0,1,6,6,6,6,6,1,0,0,0,0,0,0,0,0,0,1,6,6,6,6,1,0,0,4,0,0,0,0,0,0,0,0,0,0,0,0,0,0,0,2,2,2,2,2,2,2,2,2,0,0,0,0,0,1],
    [1,0,0,0,0,1,1,1,5,1,1,1,0,0,0,0,0,3,0,0,0,1,6,6,6,6,1,0,0,4,0,0,0,0,0,0,3,0,0,0,0,0,0,0,0,0,2,2,2,2,2,2,2,0,0,0,0,0,0,1],
    [1,0,0,0,0,0,0,0,4,0,0,0,0,0,0,0,0,0,0,0,0,1,1,1,5,1,1,0,0,4,0,0,0,0,0,0,0,0,0,0,0,0,0,3,0,0,0,2,2,2,2,2,0,0,0,3,0,0,0,1],
    [1,0,0,0,0,0,0,0,4,0,0,0,0,0,0,0,0,0,0,0,0,0,0,0,4,0,0,0,0,4,0,0,0,0,0,0,0,0,0,0,0,0,0,0,0,0,0,0,0,0,0,0,0,0,0,0,0,0,0,1],
    [1,3,0,0,0,0,0,0,4,0,0,0,0,0,3,0,0,0,0,0,0,0,0,0,4,0,0,0,0,4,0,0,0,0,0,0,0,0,0,0,0,3,0,0,0,0,0,0,0,0,0,0,0,0,0,0,3,0,0,1],
    [1,0,0,0,0,0,0,0,4,0,0,0,0,0,0,0,0,0,0,0,0,0,0,0,4,0,0,0,0,4,0,0,0,0,0,0,0,0,0,0,0,0,0,0,0,0,0,0,0,0,0,0,0,0,0,0,0,0,0,1],
    [1,0,0,0,0,0,0,0,4,4,4,4,4,4,4,4,4,4,4,4,4,4,4,4,4,4,4,4,4,4,4,4,4,4,4,4,4,4,4,4,4,4,4,4,4,4,4,4,4,4,4,0,0,0,0,0,0,0,0,1],
    [1,0,0,3,0,0,0,0,4,0,0,0,0,0,0,0,0,0,0,0,0,0,0,0,0,0,0,0,0,4,0,0,0,0,0,0,0,0,0,0,0,0,0,0,0,0,0,0,0,0,4,0,0,8,8,0,0,0,0,1],
    [1,0,0,0,0,0,0,0,4,0,0,0,0,0,0,0,0,0,0,0,0,0,0,4,4,4,4,0,0,4,0,0,0,0,0,4,4,4,4,0,0,0,0,0,0,0,0,0,0,0,4,0,0,3,0,0,0,0,0,1],
    [1,0,0,0,0,0,0,0,4,0,0,0,0,0,0,0,0,0,0,0,0,0,0,4,0,0,4,0,0,4,4,0,0,0,0,4,0,0,4,0,0,0,0,0,0,0,0,0,0,0,4,0,0,8,0,0,0,0,0,1],
    [1,0,0,0,0,0,0,0,4,0,0,0,0,0,0,0,0,0,0,0,0,0,0,4,0,0,4,0,0,4,4,0,0,0,0,4,0,0,4,0,0,0,0,0,0,0,0,0,0,0,4,0,0,8,8,3,0,0,0,1],
    [1,0,0,0,0,0,0,0,4,4,4,4,4,4,4,4,4,4,4,4,4,4,4,4,4,4,4,4,4,4,4,4,4,4,4,4,4,4,4,4,4,4,4,4,4,4,4,4,4,4,4,0,0,0,0,0,0,0,0,1],
    [1,0,0,0,0,0,0,0,4,0,0,0,0,0,0,0,0,0,0,0,0,0,0,0,4,0,0,0,0,4,0,0,0,0,0,0,0,0,0,0,0,0,0,0,0,0,0,0,0,0,4,0,0,0,0,0,0,0,0,1],
    [1,0,7,7,7,7,0,0,4,0,0,0,0,0,0,0,0,0,0,0,0,0,0,0,4,0,0,0,0,4,0,0,0,0,0,0,0,0,0,0,0,0,0,1,1,1,1,1,1,0,4,0,0,0,0,0,0,0,0,1],
    [1,0,7,0,0,7,0,0,4,0,0,0,3,0,0,0,0,0,0,0,0,0,0,0,4,0,0,0,0,4,0,0,0,0,0,3,0,0,0,0,0,0,0,1,6,6,6,6,1,0,4,0,0,0,0,0,0,0,0,1],
    [1,0,7,0,0,7,0,0,4,0,0,0,0,0,0,0,0,0,0,0,0,0,0,0,4,0,0,0,0,4,0,0,0,0,0,0,0,0,0,0,0,0,0,1,6,6,6,6,1,0,4,0,0,0,3,0,0,0,0,1],
    [1,0,7,0,0,7,0,0,4,0,0,0,0,0,0,0,3,0,0,0,0,0,0,0,4,0,0,3,0,4,0,0,0,0,0,0,0,0,0,3,0,0,0,1,6,6,6,6,1,0,4,0,0,0,0,0,0,0,0,1],
    [1,0,7,7,7,7,0,0,4,0,0,0,0,0,0,0,0,0,0,0,0,0,0,0,4,0,0,0,0,4,0,0,0,0,0,0,0,0,0,0,0,0,0,1,1,1,5,1,1,0,4,0,0,0,0,0,0,0,0,1],
    [1,0,0,0,4,0,0,0,4,0,0,0,0,0,0,0,0,0,0,0,0,0,0,0,4,0,0,0,0,4,0,0,0,0,0,0,0,0,0,0,0,0,0,0,0,0,4,0,0,0,4,0,0,0,0,0,3,0,0,1],
    [1,1,1,1,5,1,1,1,0,0,0,0,0,0,0,0,0,0,0,0,0,0,0,0,4,0,0,0,0,4,0,0,0,0,0,0,0,0,3,0,0,0,0,0,0,0,4,0,0,0,4,0,0,0,0,0,0,0,0,1],
    [1,1,6,6,6,6,6,1,0,0,0,0,0,3,0,0,3,0,0,0,0,0,0,0,4,4,4,4,4,4,0,0,0,0,0,0,0,0,0,0,0,0,0,0,0,0,4,4,4,4,4,0,0,0,0,0,0,0,0,1],
    [1,1,6,6,6,6,6,1,0,0,0,0,0,0,0,0,0,0,3,0,0,0,0,0,0,0,0,0,0,0,0,0,0,8,8,8,0,0,0,0,3,0,0,0,0,0,0,0,0,0,0,0,0,0,3,0,0,3,0,1],
    [1,1,6,6,6,6,6,1,0,0,0,3,0,0,0,0,0,0,0,0,0,3,0,0,0,0,0,0,0,0,0,0,0,8,8,8,0,0,0,0,0,0,0,0,0,0,0,0,0,0,0,0,3,0,0,0,0,0,0,1],
    [1,1,1,1,1,1,1,1,1,1,1,1,1,1,1,1,1,1,1,1,1,1,1,1,1,1,1,1,1,1,1,1,1,1,1,1,1,1,1,1,1,1,1,1,1,1,1,1,1,1,1,1,1,1,1,1,1,1,1,1]
  ],
  "legend": {
    "0": {"char": ".", "fg": "green", "walkable": true, "name": "grass"},
    "1": {"char": "#", "fg": "gray", "walkable": false, "name": "wall"},
    "2": {"char": "~", "fg": "blue", "walkable": false, "name": "water"},
    "3": {"char": "T", "fg": "green", "walkable": false, "name": "tree"},
    "4": {"char": ".", "fg": "yellow", "walkable": true, "name": "path"},
    "5": {"char": "+", "fg": "bright_yellow", "walkable": true, "name": "door"},
    "6": {"char": ".", "fg": "bright_white", "walkable": true, "name": "floor"},
    "7": {"char": "|", "fg": "yellow", "walkable": false, "name": "fence"},
    "8": {"char": "*", "fg": "bright_red", "walkable": true, "name": "flowers"}
  }
}
