{
  "name": "Town Square",
  "width": 60,
  "height": 30,
  "spawn": {"x": 30, "y": 15},
  "tiles": [
    [1,1,1,1,1,1,1,1,1,1,1,1,1,1,1,1,1,1,1,1,1,1,1,1,1,1,1,1,1,1,1,1,1,1,1,1,1,1,1,1,1,1,1,1,1,1,1,1,1,1,1,1,1,1,1,1,1,1,1,1],
    [1,0,0,3,0,0,0,0,0,0,0,0,0,0,8,8,0,0,3,0,0,0,0,0,0,0,0,0,0,4,0,0,0,0,0,0,0,0,0,0,0,0,3,0,0,3,0,0,0,3,0,0,3,0,0,3,0,0,0,1],
    [1,0,0,0,0,1,1,1,1,1,1,1,0,0,8,0,0,0,0,0,0,0,0,0,0,0,0,0,0,4,0,0,0,0,0,0,0,0,0,0,0,0,0,0,0,0,0,0,3,0,0,0,0,0,3,0,0,0,0,1],
    [1,0,0,0,0,1,6,6,6,6,6,1,0,0,3,0,0,0,0,0,0,0,0,0,0,0,0,0,0,4,0,0,0,0,0,0,0,0,0,0,0,0,0,3,0,0,0,2,2,2,2,2,0,0,0,0,0,0,0,1],
    [1,0,3,0,0,1,6,6,6,6,6,1,0,0,0,0,0,0,0,0,0,1,1,1,1,1,1,0,0,4,0,0,0,0,0,0,0,0,0,3,0,0,0,0,0,0,2,2,2,2,2,2,2,0,0,0,3,0,0,1],
    [1,0,0,0,0,1,6,6,6,6,6,1,0,0,0,0,0,0,0,0,0,1,6,6,6,6,1,0,0,4,0,0,0,0,0,0,0,0,0,0,0,0,0,0,0,2,2,2,2,2,2,2,2,2,0,0,0,0,0,1],
    [1,0,0,0,0,1,6,6,6,6,6,1,0,0,0,0,0,0,0,0,0,1,6,6,6,6,1,0,0,4,0,0,0,0,0,0,0,0,0,0,0,0,0,0,0,2,2,2,2,2,2,2,2,2,0,0,0,0,0,1],
    [1,0,0,0,0,1,1,1,5,1,1,1,0,0,0,0,0,3,0,0,0,1,6,6,6,6,1,0,0,4,0,0,0,0,0,0,3,0,0,0,0,0,0,0,0,0,2,2,2,2,2,2,2,0,0,0,0,0,0,1],
    [1,0,0,0,0,0,0,0,4,0,0,0,0,0,0,0,0,0,0,0,0,1,1,1,5,1,1,0,0,4,0,0,0,0,0,0,0,0,0,0,0,0,0,3,0,0,0,2,2,2,2,2,0,0,0,3,0,0,0,1],
    [1,0,0,0,0,0,0,0,4,0,0,0,0,0,0,0,0,0,0,0,0,0,0,0,4,0,0,0,0,4,0,0,0,0,0,0,0,0,0,0,0,0,0,0,0,0,0,0,0,0,0,0,0,0,0,0,0,0,0,1],
    [1,3,0,0,0,0,0,0,4,0,0,0,0,0,3,0,0,0,0,0,0,0,0,0,4,0,0,0,0,4,0,0,0,0,0,0,0,0,0,0,0,3,0,0,0,0,0,0,0,0,0,0,0,0,0,0,3,0,0,1],
    [1,0,0,0,0,0,0,0,4,0,0,0,0,0,0,0,0,0,0,0,0,0,0,0,4,0,0,0,0,4,0,0,0,0,0,0,0,0,0,0,0,0,0,0,0,0,0,0,0,0,0,0,0,0,0,0,0,0,0,1],
    [1,0,0,0,0,0,0,0,4,4,4,4,4,4,4,4,4,4,4,4,4,4,4,4,4,4,4,4,4,4,4,4,4,4,4,4,4,4,4,4,4,4,4,4,4,4,4,4,4,4,4,0,0,0,0,0,0,0,0,1],
    [1,0,0,3,0,0,0,0,4,0,0,0,0,0,0,0,0,0,0,0,0,0,0,0,0,0,0,0,0,4,0,0,0,0,0,0,0,0,0,0,0,0,0,0,0,0,0,0,0,0,4,0,0,0,0,0,0,0,0,0],
    [1,0,0,0,0,0,0,0,4,0,0,0,0,0,0,0,0,0,0,0,0,0,0,4,4,4,4,0,0,4,0,0,0,0,0,4,4,4,4,0,0,0,0,0,0,0,0,0,0,0,4,4,4,4,4,4,4,4,4,4],
    [1,0,0,0,0,0,0,0,4,0,0,0,0,0,0,0,0,0,0,0,0,0,0,4,0,0,4,0,0,4,4,0,0,0,0,4,0,0,4,0,0,0,0,0,0,0,0,0,0,0,4,4,4,4,4,4,4,4,4,4],
    [1,0,0,0,0,0,0,0,4,0,0,0,0,0,0,0,0,0,0,0,0,0,0,4,0,0,4,0,0,4,4,0,0,0,0,4,0,0,4,0,0,0,0,0,0,0,0,0,0,0,4,4,4,4,4,4,4,4,4,4],
    [1,0,0,0,0,0,0,0,4,4,4,4,4,4,4,4,4,4,4,4,4,4,4,4,4,4,4,4,4,4,4,4,4,4,4,4,4,4,4,4,4,4,4,4,4,4,4,4,4,4,4,0,0,0,0,0,0,0,0,0],
    [1,0,0,0,0,0,0,0,4,0,0,0,0,0,0,0,0,0,0,0,0,0,0,0,4,0,0,0,0,4,0,0,0,0,0,0,0,0,0,0,0,0,0,0,0,0,0,0,0,0,4,0,0,0,0,0,0,0,0,1],
    [1,0,1,1,1,1,1,0,4,0,0,0,0,0,0,0,0,0,0,0,0,0,0,0,4,0,0,0,0,4,0,0,0,0,0,0,0,0,0,0,0,0,0,1,1,1,1,1,1,0,4,0,0,0,0,0,0,0,0,1],
    [1,0,1,6,6,6,1,0,4,0,0,0,3,0,0,0,0,0,0,0,0,0,0,0,4,0,0,0,0,4,0,0,0,0,0,3,0,0,0,0,0,0,0,1,6,6,6,6,1,0,4,0,0,0,0,0,0,0,0,1],
    [1,0,1,6,6,6,1,0,4,0,0,0,0,0,0,0,0,0,0,0,0,0,0,0,4,0,0,0,0,4,0,0,0,0,0,0,0,0,0,0,0,0,0,1,6,6,6,6,1,0,4,0,0,0,3,0,0,0,0,1],
    [1,0,1,6,6,6,1,0,4,0,0,0,0,0,0,0,3,0,0,0,0,0,0,0,4,0,0,3,0,4,0,0,0,0,0,0,0,0,0,3,0,0,0,1,6,6,6,6,1,0,4,0,0,0,0,0,0,0,0,1],
    [1,0,1,1,5,1,1,0,4,0,0,0,0,0,0,0,0,0,0,0,0,0,0,0,4,0,0,0,0,4,0,0,0,0,0,0,0,0,0,0,0,0,0,1,1,1,5,1,1,0,4,0,0,0,0,0,0,0,0,1],
    [1,0,0,0,4,4,4,4,4,0,0,0,0,0,0,0,0,0,0,0,0,0,0,0,4,0,0,0,0,4,0,0,0,0,0,0,0,0,0,0,0,0,0,0,0,0,4,0,0,0,4,0,0,0,0,0,3,0,0,1],
    [1,7,7,7,7,7,7,7,0,0,0,0,0,0,0,0,0,0,0,0,0,0,0,0,4,0,0,0,0,4,0,0,0,0,0,0,0,0,3,0,0,0,0,0,0,0,4,0,0,0,4,0,0,0,0,0,0,0,0,1],
    [1,7,0,0,0,0,0,7,0,0,0,0,0,3,0,0,3,0,0,0,0,0,0,0,4,4,4,4,4,4,0,0,0,0,0,0,0,0,0,0,0,0,0,0,0,0,4,4,4,4,4,0,0,0,0,0,0,0,0,1],
    [1,7,0,0,0,0,0,7,0,0,0,0,0,0,0,0,0,0,3,0,0,0,0,0,0,0,0,0,0,0,0,0,0,8,8,8,0,0,0,0,3,0,0,0,0,0,0,0,0,0,0,0,0,0,3,0,0,3,0,1],
    [1,7,7,7,7,7,7,7,0,0,0,3,0,0,0,0,0,0,0,0,0,3,0,0,0,0,0,0,0,0,0,0,0,8,8,8,0,0,0,0,0,0,0,0,0,0,0,0,0,0,0,0,3,0,0,0,0,0,0,1],
    [1,1,1,1,1,1,1,1,1,1,1,1,1,1,1,1,1,1,1,1,1,1,1,1,1,1,1,1,1,1,1,1,1,1,1,1,1,1,1,1,1,1,1,1,1,1,1,1,1,1,1,1,1,1,1,1,1,1,1,1]
  ],
  "legend": {
    "0": {"char": ".", "fg": "green", "walkable": true, "name": "grass"},
    "1": {"char": "#", "fg": "gray", "walkable": false, "name": "wall"},
    "2": {"char": "~", "fg": "blue", "walkable": false, "name": "water"},
    "3": {"char": "T", "fg": "green", "walkable": false, "name": "tree"},
    "4": {"char": ".", "fg": "yellow", "walkable": true, "name": "path"},
    "5": {"char": "+", "fg": "bright_yellow", "walkable": true, "name": "door"},
    "6": {"char": ".", "fg": "bright_white", "walkable": true, "name": "floor"},
    "7": {"char": "|", "fg": "yellow", "walkable": false, "name": "fence"},
    "8": {"char": "*", "fg": "bright_red", "walkable": true, "name": "flowers"}
  },
  "portals": [
    {"x": 59, "y": 13, "target_map": "Forest", "target_x": 1, "target_y": 13},
    {"x": 59, "y": 14, "target_map": "Forest", "target_x": 1, "target_y": 14},
    {"x": 59, "y": 15, "target_map": "Forest", "target_x": 1, "target_y": 15},
    {"x": 59, "y": 16, "target_map": "Forest", "target_x": 1, "target_y": 16},
    {"x": 59, "y": 17, "target_map": "Forest", "target_x": 1, "target_y": 17}
  ],
  "interactions": [
    {"x": 9,  "y": 7,  "type": "sign", "text": "General Store"},
    {"x": 25, "y": 8,  "type": "sign", "text": "Town Hall"},
    {"x": 5,  "y": 23, "type": "sign", "text": "The Rusty Anchor"},
    {"x": 47, "y": 23, "type": "sign", "text": "Healer's Hut"}
  ]
}
